1111111111111111111
1222222221222222221
1311211121211121131
1222222222222222221
1211212111112121121
1222212221222122221
1111211101011121111
000121000b000121000
1111210110110121111
40002001ipc10020004
1111210111110121111
0001210000000121000
1111210111110121111
1222222221222222221
1211211121211121121
132122222x222221231
1121212111112121211
1222212221222122221
1211111121211111121
1222222222222222221
1111111111111111111
